'S___X_X___'
'X__X______'
'__________'
'_____X____'
'_X_X______'
'X_________'
'_________X'
'X_________'
'___XX___X_'
'_X_X_____E'