  0 1 2 3 4
0 S _ _ _ _
1 _ _ _ _ _
2 _ _ _ _ _
3 _ _ _ _ _
4 _ _ _ E _